1111111111111
1E110C00000C1
1000011111001
1P001100000C1
1111111111111