1111111111111111111111111111111111111111111111111111111111111111111111111111111111111111111111111111
1P00000000000000000111111111111111111111111111111111111111111111111111111111111111111111111111111111
1001000000011111100111111111111111111111111111111111111111111111111111111111111111111111111111111111
1001000000000000010111111111111111111111111111111111111111111111111111111111111111111111111111111111
1001000000000000010111111111111111111111111111111111111111111111111111111111111111111111111111111111
1001000000000000010111111111111111111111111111111111111111111111111111111111111111111111111111111111
1001000000000000010111111111111111111111111111111111111111111111111111111111111111111111111111111111
1001000000000000010111111111111111111111111111111111111111111111111111111111111111111111111111111111
1001000000001111100111111111111111111111111111111111111111111111111111111111111111111111111111111111
1001001000010000000111111111111111111111111111111111111111111111111111111111111111111111111111111111
1001001000010000000111111111111111111111111111111111111111111111111111111111111111111111111111111111
1001111111010000000111111111111111111111111111111111111111111111111111111111111111111111111111111111
1000001000010000000111111111111111111111111111111111111111111111111111111111111111111111111111111111
1000001000010000000111111111111111111111111111111111111111111111111111111111111111111111111111111111
1000001000001111110111111111111111111111111111111111111111111111111111111111111111111111111111111111
1000000000000000000111111111111111111111111111111111111111111111111111111111111111111111111111111111
1000000C00000000000111111111111111111111111111111111111111111111111111111111111111111111111111111111
1000000000000000000111111111111111111111111111111111111111111111111111111111111111111111111111111111
100000000000000000E111111111111111111111111111111111111111111111111111111111111111111111111111111111
1111111111111111111111111111111111111111111111111111111111111111111111111111111111111111111111111111
1000000000000000000111111111111111111111111111111111111111111111111111111111111111111111111111111111
1000000000000000000111111111111111111111111111111111111111111111111111111111111111111111111111111111
1000000000000000000111111111111111111111111111111111111111111111111111111111111111111111111111111111
1000000000000000000111111111111111111111111111111111111111111111111111111111111111111111111111111111
1000000000000000000111111111111111111111111111111111111111111111111111111111111111111111111111111111
1000000000000000000111111111111111111111111111111111111111111111111111111111111111111111111111111111
1000000000000000000111111111111111111111111111111111111111111111111111111111111111111111111111111111
1000000000000000000111111111111111111111111111111111111111111111111111111111111111111111111111111111
1000000000000000000111111111111111111111111111111111111111111111111111111111111111111111111111111111
1000000000000000000111111111111111111111111111111111111111111111111111111111111111111111111111111111
1000000000000000000111111111111111111111111111111111111111111111111111111111111111111111111111111111
1000000000000000000111111111111111111111111111111111111111111111111111111111111111111111111111111111
1000000000000000000111111111111111111111111111111111111111111111111111111111111111111111111111111111
1000000000000000000111111111111111111111111111111111111111111111111111111111111111111111111111111111
1000000000000000000111111111111111111111111111111111111111111111111111111111111111111111111111111111
1000000000000000000111111111111111111111111111111111111111111111111111111111111111111111111111111111
1000000000000000000111111111111111111111111111111111111111111111111111111111111111111111111111111111
1000000000000000000111111111111111111111111111111111111111111111111111111111111111111111111111111111
1000000000000000000111111111111111111111111111111111111111111111111111111111111111111111111111111111
1000000000000000000111111111111111111111111111111111111111111111111111111111111111111111111111111111
1000000000000000000111111111111111111111111111111111111111111111111111111111111111111111111111111111
1000000000000000000111111111111111111111111111111111111111111111111111111111111111111111111111111111
1000000000000000000111111111111111111111111111111111111111111111111111111111111111111111111111111111
1000000000000000000111111111111111111111111111111111111111111111111111111111111111111111111111111111
1000000000000000000111111111111111111111111111111111111111111111111111111111111111111111111111111111
1000000000000000000111111111111111111111111111111111111111111111111111111111111111111111111111111111
1000000000000000000111111111111111111111111111111111111111111111111111111111111111111111111111111111
1000000000000000000111111111111111111111111111111111111111111111111111111111111111111111111111111111
1000000000000000000111111111111111111111111111111111111111111111111111111111111111111111111111111111
1000000000000000000111111111111111111111111111111111111111111111111111111111111111111111111111111111
1000000000000000000111111111111111111111111111111111111111111111111111111111111111111111111111111111
1000000000000000000111111111111111111111111111111111111111111111111111111111111111111111111111111111
1000000000000000000111111111111111111111111111111111111111111111111111111111111111111111111111111111
1000000000000000000111111111111111111111111111111111111111111111111111111111111111111111111111111111
1000000000000000000111111111111111111111111111111111111111111111111111111111111111111111111111111111
1000000000000000000111111111111111111111111111111111111111111111111111111111111111111111111111111111
1000000000000000000111111111111111111111111111111111111111111111111111111111111111111111111111111111
1000000000000000000111111111111111111111111111111111111111111111111111111111111111111111111111111111
1000000000000000000111111111111111111111111111111111111111111111111111111111111111111111111111111111
1000000000000000000111111111111111111111111111111111111111111111111111111111111111111111111111111111
1000000000000000000111111111111111111111111111111111111111111111111111111111111111111111111111111111
1000000000000000000111111111111111111111111111111111111111111111111111111111111111111111111111111111
1000000000000000000111111111111111111111111111111111111111111111111111111111111111111111111111111111
1000000000000000000111111111111111111111111111111111111111111111111111111111111111111111111111111111
1000000000000000000111111111111111111111111111111111111111111111111111111111111111111111111111111111
1000000000000000000111111111111111111111111111111111111111111111111111111111111111111111111111111111
1000000000000000000111111111111111111111111111111111111111111111111111111111111111111111111111111111
1000000000000000000111111111111111111111111111111111111111111111111111111111111111111111111111111111
1000000000000000000111111111111111111111111111111111111111111111111111111111111111111111111111111111
1000000000000000000111111111111111111111111111111111111111111111111111111111111111111111111111111111
1000000000000000000111111111111111111111111111111111111111111111111111111111111111111111111111111111
1000000000000000000111111111111111111111111111111111111111111111111111111111111111111111111111111111
1000000000000000000111111111111111111111111111111111111111111111111111111111111111111111111111111111
1000000000000000000111111111111111111111111111111111111111111111111111111111111111111111111111111111
1000000000000000000111111111111111111111111111111111111111111111111111111111111111111111111111111111
1000000000000000000111111111111111111111111111111111111111111111111111111111111111111111111111111111
1000000000000000000111111111111111111111111111111111111111111111111111111111111111111111111111111111
1000000000000000000111111111111111111111111111111111111111111111111111111111111111111111111111111111
1000000000000000000111111111111111111111111111111111111111111111111111111111111111111111111111111111
1000000000000000000111111111111111111111111111111111111111111111111111111111111111111111111111111111
1000000000000000000111111111111111111111111111111111111111111111111111111111111111111111111111111111
1000000000000000000111111111111111111111111111111111111111111111111111111111111111111111111111111111
1000000000000000000111111111111111111111111111111111111111111111111111111111111111111111111111111111
1000000000000000000111111111111111111111111111111111111111111111111111111111111111111111111111111111
1000000000000000000111111111111111111111111111111111111111111111111111111111111111111111111111111111
1000000000000000000111111111111111111111111111111111111111111111111111111111111111111111111111111111
1000000000000000000111111111111111111111111111111111111111111111111111111111111111111111111111111111
1000000000000000000111111111111111111111111111111111111111111111111111111111111111111111111111111111
1000000000000000000111111111111111111111111111111111111111111111111111111111111111111111111111111111
1000000000000000000111111111111111111111111111111111111111111111111111111111111111111111111111111111
1000000000000000000111111111111111111111111111111111111111111111111111111111111111111111111111111111
1000000000000000000111111111111111111111111111111111111111111111111111111111111111111111111111111111
1000000000000000000111111111111111111111111111111111111111111111111111111111111111111111111111111111
1000000000000000000111111111111111111111111111111111111111111111111111111111111111111111111111111111
1000000000000000000111111111111111111111111111111111111111111111111111111111111111111111111111111111
1000000000000000000111111111111111111111111111111111111111111111111111111111111111111111111111111111
1000000000000000000111111111111111111111111111111111111111111111111111111111111111111111111111111111
1000000000000000000111111111111111111111111111111111111111111111111111111111111111111111111111111111
1000000000000000000111111111111111111111111111111111111111111111111111111111111111111111111111111111
1000000000000000000111111111111111111111111111111111111111111111111111111111111111111111111111111111
1000000000000000000111111111111111111111111111111111111111111111111111111111111111111111111111111111
1000000000000000000111111111111111111111111111111111111111111111111111111111111111111111111111111111
1000000000000000000111111111111111111111111111111111111111111111111111111111111111111111111111111111
1000000000000000000111111111111111111111111111111111111111111111111111111111111111111111111111111111
1000000000000000000111111111111111111111111111111111111111111111111111111111111111111111111111111111
1000000000000000000111111111111111111111111111111111111111111111111111111111111111111111111111111111
1000000000000000000111111111111111111111111111111111111111111111111111111111111111111111111111111111
1000000000000000000111111111111111111111111111111111111111111111111111111111111111111111111111111111
1000000000000000000111111111111111111111111111111111111111111111111111111111111111111111111111111111
1111111111111111111111111111111111111111111111111111111111111111111111111111111111111111111111111111