1111111111
1P01C01011
1001001011
1000000001
11111100C1
1011111001
101E100011
10100F0001
1011100111
1111111111