111111111111111111111111111111
1P0011111111111111111111111111
100000000000001011111111111111
101111110110101111010010000011
100101110111000111101111110111
110111110100010011111111110111
110000010111010011010100010111
111011111111011111111111110111
11101101C000011111111001011111
11101111001100000C111011110111
111011111111110110111011111111
111000000000110110000000110111
111111111110111110111101111111
111111111111111110011101111111
111111111111111110100101011111
100000001111111110111101011111
111111111000C00000111100000111
111111111011101110101101110111
1111111100111011101C1101111111
111111000111100110101111111111
11111001011111111000000000C011
111100110000010001111111111011
11C0011101010101000F0000000011
1001111111110001111111111110E1
111111111111111111111111111111