1111111111111
10110C00000C1
1100011111001
1P001100000E1
1111111111111