11111111111111111111111111111111111111111
1000001000100000000C1010000000001000001C1
10111010101110111111101011111110111011101
10001C1C100000101000000000100000100000001
10101111101111101011101111111010111011111
10100000100010100010000010100010001000101
10101110101110111110101110111110111110101
10101000000000100000100000101000100010101
11101110101110111011111110101011111010101
1C1010001010000000000010001010000000C0101
10111011111111111011101010101111111010101
10000010001000100010101010101010000010001
11111111101110101010101111101010111110111
10000000100000001000101000000000001010001
10111111101111111010111111101111111011101
10000000000000001010000000100000100010001
10111111111111111011101011101011101010111
100000101P0000000010001010001000001010001
10111110111110111111101111111011111110101
101000001000000000100010101010100010001C1
11111011101110111010111010101111101111111
10001000001000001010001000001000100000001
10101011101111101011111111101010111110101
10100010100010001000000000000010100010101
11111010111010111010111110111011111010101
10101010001010001010100010001000100000101
10101111101011111111101111101110111010111
10100000000000001000000000100010100010001
10111011111011101011101011101110111011101
10100000101000101010001000000010001010101
10111011101111101011101111111110111010101
10000000100000001010001010000000001000101
11111011111111101111101010101010101010101
10000000001000000000100010101010100010101
11111011101011111110101011111010101110111
1C001000101000101000101000101010101000101
10111011111111101010111111101011111011101
10100000000000001010001C10001010000000101
10101110111011111010111010111010101010101
10000010100000001010000010000010101E10001
11111111111111111111111111111111111111111