111111111111111111111111111111
1001000010000000000100000E1001
100100000100000000100000000101
100100000010000001000000000011
100100000001000010000000000001
100100000000100100000000000001
100100000000011000000000000001
100100000000000000000000000001
100100000000000000000000000001
100100000000000000000000000001
100100000000000000000000000001
100100000000000000000000000001
100100000000000000000000000001
100100000000000000000000000001
10010000000000FC00000000000001
100100000000000000000000000011
100100000000000000000000000101
100100000000000000000000001001
100100000000000000000000010001
100100000000000000000000100001
100100000000000000000001000001
100100000000000000000010000001
100100000000000000000100000001
100100000000000000001000000001
100100000000000000010000000001
100100000000000000100000000001
100100000000000001000000000001
100100000000000010000000000001
1001P0000000000100000000000001
111111111111111111111111111111