1111111111
1P100000E1
1010000111
1010000C01
10000001C1
1111111111