111111
1E11C1
101101
1C1101
1P1101
111111